How to say funny sex number in every language 
Afrikaans: nege en sestig

Albanian: gjashtÃ«dhjetÃ« nÃ«ntÃ«

Amharic: áˆµáˆáˆ³ á‹˜áŒ áŠ (sillisa zetenyi)

Arabic: ØªØ³Ø¹Ø© ÙˆØ³ØªÙˆÙ† (tset wstwn)

Armenian: Õ¾Õ¡Õ©Õ½Õ¸Ö‚Õ¶Õ«Õ¶Õ¨ (vatsuniny)

Azerbaijani: altmÄ±ÅŸ doqquz

Basque: hirurogeita bederatzi

Belarusian: ÑˆÑÑÑ†ÑŒÐ´Ð·ÐµÑÑÑ‚ Ð´Ð·ÐµÐ²ÑÑ†ÑŒ (sescdziesiat dzevyats)

Bengali: à¦‰à¦¨à¦¸à¦¤à§à¦¤à§à¦° (unasattura)

Bosnian: Å¡ezdeset devet

Bulgarian: ÑˆÐµÑÑ‚Ð´ÐµÑÐµÑ‚ Ð¸ Ð´ÐµÐ²ÐµÑ‚ (shestdeset ee devet)

Catalan: seixanta-nou

Cebuanu: kan-uman ug siyam

Chichewa: makumi asanu ndi limodzi mphambu zisanu ndi zinayi (what the fuck)

Chinese: å…­åä¹ (liushiju)

Corsican: sessanta nove

Croatian: Å¡ezdeset devet

Czech: Å¡edesÃ¡tdevÄ›t

Danish: niogtres

Dutch: negenenzestig

English: four twenty

Esperanto: sesdek naÅ­

Estonian: kuuskÃ¼mmend Ã¼heksa

Filipino: animnapu't siyam

Finnish: kuusikymmentÃ¤yhdeksÃ¤n

French: soixante neuf

Frisian: njoggenensechstich

Galician: sesenta e nove

Georgian: áƒ¡áƒáƒ›áƒáƒªáƒ“áƒáƒªáƒ®áƒ áƒ (samotsdatskhra)

German: neunundsechzig

Greek: ÎµÎ¾Î®Î½Ï„Î± ÎµÎ½Î½Î­Î± (exinta ennea)

Gujarati: àª“àª—àª£ àª¸àª¿àª¤à«‡àª° (ogana sitera)

Haitian: swasant nÃ¨f

Hausa: sittin da tara

Hawaiian: kanaono kumamaiwa

Hebrew: ×©×Ö´×©×Ö´×™× ×ªÖµ×©×Ö·×¢ 

Hindi: à¤‰à¤¨à¤¹à¤¤à¥à¤¤à¤° (unahattar)

Hmong: rau caum cuaj

Hungarian: hatvan kilenc

Icelandic: sextÃ­u og nÃ­u

Igbo: iri isii na itoolu

Indonesian: enam puluh sembilan

Irish: seasca a naoi

Italian: sessanta nove

Japanese: å…­åä¹ (rokujukyu)

Javanese: sewidak sanga

Kannada: à²…à²°à²µà²¤à³à²¤à³†à³‚à²‚à²¬à²¤à³à²¤à³ (aravattombattu)

Kazakh: Ð°Ð»Ð¿Ñ‹Ñ Ñ‚Ð¾Ò“Ñ‹Ð· (alpis togiz)

Khmer: áž áž»áž€ážŸáž·áž”â€‹áž”áŸ’ážšáž¶áŸ†áž”áž½áž“ (hokseb brabuon)

Kinyarwanda: mirongo itandatu n'icyenda

Korean: ì˜ˆìˆœ ì•„í™‰ (yesun ahob)

Kurdish: ÅŸÃªst Ã» neh

Kyrgyz: ÐÐ»Ñ‚Ñ‹Ð¼Ñ‹Ñˆ Ñ‚Ð¾Ð³ÑƒÐ· (altimish togooz)

Lao: àº«àº»àºàºªàº´àºšà»€àºàº»à»‰àº² (hok sib kao)

Latin: sexaginta novem

Lativian: seÅ¡desmit deviÅ†i

Lithuanian: Å¡eÅ¡iasdeÅ¡imt devynis

Luxembourgish: nÃ©ngechanzechanzeg

Macedonian: ÑˆÐµÐµÑÐµÑ‚ Ð´ÐµÐ²ÐµÑ‚

Malagasy: sivy amby enimpolo

Malay: enam puluh sembilan

Malayalam: à´…à´±àµà´ªà´¤àµà´¤à´¿à´¯àµŠà´®àµà´ªà´¤àµ ( lmao fuck you im not depicting this shit )

Maltese: disgÄ§a u sittin

Maori: ono tekau ma iwa

Marathi: à¤à¤•à¥‹à¤£ à¤¸à¤¤à¥à¤¤à¤° (ekona sattara)

Mongolian: Ð¶Ð°Ñ€Ð°Ð½ ÐµÑ (zharan yes)

Myanmar: á€á€¼á€±á€¬á€€á€ºá€†á€šá€ºá€€á€­á€¯á€¸ ( who the fuck speaks like this)

Nepali: à¤‰à¤¨à¤¨à¥à¤¸à¤¤à¥à¤¤à¤°à¥€ (unansattari)

Norweigan: sekstini

Odia: à¬·à¬¾à¬ à¬¿à¬ (ooga booga i speak like a fucking frog)

Pashto: Ù†Ù‡Ù‡ Ø´Ù¾ÛØªÙ‡

Persian: Ø´ØµØª Ùˆ Ù†Ù‡

Polish: szeÅ›Ä‡dziesiÄ…t dziewiÄ™Ä‡

Portugese: sessenta e nove

Punjabi: à¨¨à©Œà¨‚ (naum)

Romanian: È™aizeci È™i nouÄƒ

Russian: ÑˆÐµÑÑ‚ÑŒÐ´ÐµÑÑÑ‚ Ð´ÐµÐ²ÑÑ‚ÑŒ (shestdesyat devyat)

Samoan: onosefulu iva

Scottish: seasgad â€™s a naoi

Serbian: ÑˆÐµÐ·Ð´ÐµÑÐµÑ‚ Ð´ÐµÐ²ÐµÑ‚ (shezdeset devet)

Sesotho: mashome a tÅ¡eletseng a metso e robong

Shona: makumi matanhatu nepfumbamwe

Sindhi: Ù†ÙˆØ§Ù†ÙˆÙŠ

Sinhala: à·„à·à¶§ à¶±à·€à¶º (haeta navaya)

Slovak: Å¡esÅ¥desiatdevÃ¤Å¥

Slovenian: devetinÅ¡estdeset

Somali: lixdan iyo sagaal

Spanish: sesenta y nueve

Sundanese: genep puluh salapan

Swahili: sitini na tisa

Swedish: sextionio

Tajik: ÑˆÐ°ÑÑ‚ Ð½Ó¯Ò³ (shast nuh)

Tamil: à®…à®±à¯à®ªà®¤à¯à®¤à¯ à®’à®©à¯à®ªà®¤à¯ (ooga booga ima scare you when you tryna sleep)

Tatar: Ð°Ð»Ñ‚Ð¼Ñ‹Ñˆ Ñ‚ÑƒÐ³Ñ‹Ð·

Telegu: à°…à°°à°µà±†à±– à°¤à±Šà°®à±à°®à°¿à°¦à°¿ (aravai tommidu)

Thai: à¸«à¸à¸ªà¸´à¸šà¹€à¸à¹‰à¸² (hk sib kea)

Turkish: altmÄ±ÅŸdokuz

Turkmen: altmyÅŸ dokuz

Ukrainian: ÑˆÑ–ÑÑ‚Ð´ÐµÑÑÑ‚ Ð´ÐµÐ²'ÑÑ‚ÑŒ

Urdu: Ø§Ù†ÛØªØ±

Uyghur: Ø¦Ø§ØªÙ…Ù‰Ø´ ØªÙˆÙ‚Ù‚Û‡Ø²

Uzbek: oltmish to'qqiz

Vietnamese: sÃ¡u mÆ°Æ¡i chÃ­n

Welsh: chwe deg naw

Xhosa: amashumi amathandathu anesithoba

Yiddish: ×–×¢×›×¦×™×§

Yoroba: á»gá»ta máº¹san

Zulu: amashumi ayisithupha nesishiyagalolunye